20
21
MMMMMMMMMMMMMMMMMMMM
M.P...MMMMMMMMMMMMMM
MMMMMOMMMMMMMMMMMMMM
MMMMM.MMMMMMMMMMMMMM
MMMMM.MMMMMMMMMMMMMM
MMMMM...C.MMMMMMMMMM
MMMMM.....MMMMMMMMMM
MMMMM...O.MMMMMMMMMM
MMMMM.C...MMMMMMMMMM
MMMMM.............OM
MMMMMMMMMMMM...MMMMM
MMMMMMMMMMMMM.MMMMMM
MMMMMMMMMMMMM.MMMMMM
MMMMMMMMMMMMM.MMMMMM
MMMMMMMMMMM.....MMMM
MMMMMMMMMMM.C...MMMM
MM...MMMMMM..C.CMMMM
MM.........M....MMMM
MMMOMMMMM..........M
MMMMMMMMM.........OM
MMMMMMMMMMMMMMMMMMMM