27
27
.MMMMMMMMMMMMMMMMMMMMMMMMM.
MM...M.......M.......M...MM
M.M..OCOCOCOC.COCOCOCO..M.M
M...OCOCOCOCOCOCOCOCOCO...M
M..OCOCOCOCOCOCOCOCOCOCO..M
MMOCOCOCOCOCOCOCOCOCOCOCOMM
M.COCOCOCOCOCOCOCOCOCOCOC.M
M.OCOCOCOCOCOCOCOCOCOCOCO.M
M.COCOCOCOCOCOCOCOCOCOCOC.M
M.OCOCOCOCOCOCOCOCOCOCOCO.M
M.COCOCOCOCOCOCOCOCOCOCOC.M
M.OCOCOCOCO.....OCOCOCOCO.M
M.COCOCOCOC..C..COCOCOCOC.M
MM.COCOCOCO.CPC.OCOCOCOC.MM
M.COCOCOCOC..C..COCOCOCOC.M
M.OCOCOCOCO.....OCOCOCOCO.M
M.COCOCOCOCOCOCOCOCOCOCOC.M
M.OCOCOCOCOCOCOCOCOCOCOCO.M
M.COCOCOCOCOCOCOCOCOCOCOC.M
M.OCOCOCOCOCOCOCOCOCOCOCO.M
M.COCOCOCOCOCOCOCOCOCOCOC.M
MMOCOCOCOCOCOCOCOCOCOCOCOMM
M..OCOCOCOCOCOCOCOCOCOCO..M
M...OCOCOCOCOCOCOCOCOCO...M
M.M..OCOCOCOC.COCOCOCO..M.M
MM...M.......M.......M...MM
.MMMMMMMMMMMMMMMMMMMMMMMMM.



